8 8 8 8 8 8 8 8 8 8 8 8 8 8 8 8 8 8 8 8 8 8 8 8 8 8 8 8 8 8 8 8 8 8 8 8 8 8 8 8 
8 8 8 8 8 8 8 8 8 8 8 8 8 8 8 8 8 8 7 7 7 7 7 7 8 8 8 8 8 8 8 7 10 7 8 8 8 8 8 8 
8 8 8 8 8 8 8 8 8 8 8 8 8 8 8 8 8 7 7 7 7 7 7 7 7 8 8 8 8 8 8 7 10 7 8 8 8 8 8 8 
8 8 8 8 8 8 8 8 8 8 8 8 8 8 8 8 8 7 7 7 7 7 7 7 7 7 8 8 8 8 8 7 10 7 8 8 8 8 8 8 
8 8 8 8 8 8 7 7 7 7 7 7 7 8 8 8 8 7 7 7 7 8 8 8 7 7 8 8 8 8 8 7 10 7 8 8 8 8 8 8 
8 8 8 8 7 7 7 7 7 7 7 7 7 7 7 7 7 7 7 8 8 8 8 8 7 7 8 8 8 8 8 7 10 7 8 8 8 8 8 8 
8 8 8 7 7 7 7 7 7 7 7 7 7 7 7 7 7 7 7 8 8 8 8 8 7 7 7 7 7 7 7 7 10 7 8 8 8 8 8 8 
8 8 8 7 7 7 7 7 7 7 7 7 7 7 7 7 7 8 8 8 8 8 8 8 7 7 7 7 7 9 9 9 10 7 8 8 8 8 8 8 
8 8 7 7 7 7 7 7 7 7 7 7 7 7 7 7 7 8 8 8 8 8 8 8 8 8 8 8 7 10 7 7 7 7 8 8 8 8 8 8 
8 8 7 7 7 7 7 7 7 7 7 7 7 7 7 7 7 8 8 8 8 8 8 8 8 8 8 8 7 10 7 8 8 8 8 8 8 8 8 8 
8 8 7 7 7 7 7 7 7 7 7 7 7 7 7 7 7 8 8 8 8 8 8 8 8 8 8 7 7 10 7 8 8 8 8 8 8 8 8 8 
8 8 7 7 7 7 7 7 7 7 7 7 7 7 7 7 8 8 8 8 8 7 7 7 7 7 7 7 7 10 7 8 8 8 8 8 8 8 8 8 
8 8 8 7 7 7 7 7 7 7 7 7 7 7 8 8 8 8 8 8 8 7 9 9 9 9 9 9 9 10 7 8 8 8 8 8 8 8 8 8 
8 8 8 8 7 7 7 7 7 7 7 7 7 7 8 8 8 8 8 8 7 7 10 7 7 7 7 7 7 7 7 8 8 8 8 7 7 8 8 8 
8 8 8 8 7 7 7 7 7 7 7 7 7 8 8 8 8 8 8 8 7 7 10 7 7 8 8 8 8 8 8 8 7 7 7 7 7 7 8 8 
8 8 8 8 8 8 7 7 7 7 7 7 8 8 8 8 8 8 8 8 7 7 10 7 7 8 8 8 8 8 8 7 7 7 7 7 7 7 7 8 
8 8 8 8 8 8 8 7 7 7 7 7 8 8 8 8 8 8 8 8 7 7 10 7 7 8 8 8 8 8 7 7 7 7 7 7 7 7 8 8 
8 8 8 8 8 8 8 7 7 7 7 7 7 8 8 8 8 7 7 7 7 7 10 7 7 7 8 7 7 7 7 7 7 7 7 7 7 7 8 8 
8 8 8 8 8 8 8 7 7 7 7 7 7 7 7 7 7 7 7 7 7 7 10 7 7 7 7 7 7 7 8 8 8 8 8 7 8 8 8 8 
8 8 8 8 8 8 8 8 7 7 7 7 7 7 7 7 7 7 7 7 7 7 10 7 7 7 7 7 8 8 8 8 8 8 8 8 8 8 8 8 
8 8 8 8 8 8 8 8 7 7 7 7 7 7 7 7 7 7 7 7 7 7 10 7 7 7 7 7 7 8 8 8 8 8 8 8 8 8 8 8 
7 7 8 8 8 8 8 8 7 7 7 7 7 7 7 7 7 7 7 7 7 7 10 7 7 7 7 7 7 7 7 8 8 8 8 8 8 8 8 8 
7 7 7 8 8 8 8 8 7 7 7 7 7 7 7 7 7 7 7 7 7 7 10 7 7 7 7 7 7 7 7 8 8 8 8 8 8 8 8 8 
7 7 7 8 8 8 8 8 7 7 7 7 7 7 7 7 7 7 7 7 7 7 10 7 7 7 7 7 7 7 7 7 8 8 8 8 8 8 8 8 
7 7 8 8 8 8 8 8 7 7 7 7 7 7 7 7 7 7 7 7 7 7 10 7 7 7 7 7 7 7 7 7 8 8 8 8 8 8 8 8 
7 8 8 8 8 8 8 8 7 7 7 7 7 7 7 7 7 7 7 7 7 7 10 7 7 7 7 7 7 7 7 7 7 8 8 8 8 8 8 8 
8 8 8 8 8 8 8 7 7 7 7 7 7 7 7 7 7 7 7 7 7 7 10 7 7 7 7 7 7 7 7 7 7 8 8 8 8 8 8 8 
8 8 8 8 8 8 8 7 7 7 7 7 7 7 7 7 7 7 7 7 7 7 9 9 9 9 7 7 7 7 7 7 7 8 8 8 8 8 8 8 
8 8 8 8 8 8 7 7 7 7 7 7 7 7 7 7 7 7 7 7 7 7 7 7 7 7 7 7 7 7 7 7 7 7 8 8 8 8 8 8 
8 8 8 8 8 7 7 7 7 7 7 7 7 7 7 7 7 7 7 7 7 7 7 7 7 7 7 7 7 7 7 7 7 7 7 8 8 8 8 8 
8 8 8 8 8 7 7 7 7 7 7 7 7 7 7 7 7 7 7 7 7 7 7 7 7 7 7 7 7 7 7 7 7 7 7 8 8 8 8 8 
8 8 8 8 8 8 8 8 8 8 8 8 8 8 8 8 8 8 8 8 8 8 8 8 8 8 8 8 8 8 8 8 8 8 8 8 8 8 8 8